0410 0498 0410 0498 0410 0498 0410 0498 0410 0498 0410 0498 0410 0498 0410 0674 0059 0147 0235 0088 0586 0674 0410 0498 0410 0498 0410 0498 0410 0498 0410 0498 0410 0498 0410 0498
0411 0499 0411 0499 0411 0499 0411 0499 0411 0499 0412 0500 0412 0500 0412 0676 0060 0148 0236 0088 0588 0500 0412 0500 0587 0499 0587 0499 0411 0499 0411 0499 0411 0499 0411 0499
0410 0498 0410 0498 0410 0498 0410 0498 0410 0498 0441 0441 0441 0088 0088 0088 0088 0088 0088 0088 0088 0441 0441 0441 0410 0498 0410 0498 0410 0498 0410 0498 0410 0498 0410 0498
0411 0499 0411 0499 0411 0499 0411 0499 0412 0676 0441 0441 0441 0441 0088 0088 0088 0088 0088 0088 0441 0441 0441 0441 0412 0500 0587 0499 0411 0499 0411 0499 0411 0499 0411 0499
0410 0498 0410 0498 0410 0498 0410 0498 0441 0441 0441 0441 0441 0441 0088 0088 0088 0088 0088 0088 0441 0441 0441 0441 0441 0441 0410 0498 0410 0498 0410 0498 0410 0498 0410 0498
0411 0499 0411 0499 0411 0499 0411 0499 0584 0672 0441 0441 0441 0088 0088 0088 0088 0088 0088 0585 0672 0441 0441 0441 0441 0441 0588 0500 0411 0499 0411 0499 0411 0499 0411 0499
0410 0498 0410 0498 0410 0498 0410 0498 0410 0674 0441 0441 0088 0088 0541 0632 0632 0632 0554 0586 0674 0584 0672 0441 0441 0088 0088 0088 0410 0498 0410 0498 0410 0498 0410 0498
0411 0499 0411 0499 0411 0499 0411 0499 0411 0499 0466 0632 0632 0632 0545 0088 0088 0088 0088 0411 0499 0410 0674 0088 0088 0058 0234 0088 0411 0499 0411 0499 0411 0499 0411 0499
0410 0498 0410 0498 0410 0498 0410 0498 0410 0498 0585 0673 0088 0088 0088 0088 0088 0088 0088 0410 0498 0412 0676 0088 0058 0147 0235 0088 0410 0498 0410 0498 0410 0498 0410 0498
0411 0499 0411 0499 0411 0499 0411 0499 0411 0499 0410 0674 0088 0264 0088 0058 0146 0234 0088 0588 0676 0441 0441 0088 0060 0147 0147 0234 0411 0499 0411 0499 0411 0499 0411 0499
0410 0498 0410 0498 0410 0498 0410 0498 0410 0498 0411 0499 0088 0058 0146 0147 0147 0235 0088 0441 0441 0441 0441 0441 0088 0060 0147 0235 0410 0498 0410 0498 0410 0498 0410 0498
0411 0499 0411 0499 0411 0499 0411 0499 0411 0499 0410 0498 0088 0060 0147 0147 0147 0236 0088 0441 0441 0441 0441 0441 0441 0088 0060 0236 0411 0499 0411 0499 0411 0499 0411 0499
0410 0498 0410 0498 0410 0498 0410 0498 0410 0498 0412 0676 0088 0088 0060 0148 0236 0088 0088 0441 0441 0441 0441 0441 0441 0088 0088 0088 0410 0498 0410 0498 0410 0498 0410 0498
0411 0499 0411 0499 0411 0499 0411 0499 0412 0676 0441 0441 0088 0088 0088 0088 0466 0632 0632 0554 0584 0672 0441 0441 0441 0088 0585 0673 0411 0499 0411 0499 0411 0499 0411 0499
0410 0498 0410 0498 0410 0498 0410 0498 0441 0441 0441 0441 0441 0088 0088 0088 0088 0088 0088 0088 0586 0674 0441 0441 0088 0088 0586 0674 0410 0498 0410 0498 0410 0498 0410 0498
0411 0499 0411 0499 0411 0499 0411 0499 0584 0672 0441 0441 0441 0441 0088 0088 0088 0088 0088 0088 0587 0499 0584 0672 0585 0673 0587 0499 0411 0499 0411 0499 0411 0499 0411 0499
0410 0498 0410 0498 0410 0498 0410 0498 0410 0674 0441 0441 0441 0441 0088 0088 0088 0088 0088 0088 0410 0498 0410 0498 0410 0498 0410 0498 0410 0498 0410 0498 0410 0498 0410 0498
0411 0499 0411 0499 0411 0499 0411 0499 0411 0499 0584 0672 0584 0673 0585 0673 0585 0673 0088 0088 0411 0499 0411 0499 0411 0499 0411 0499 0411 0499 0411 0499 0411 0499 0411 0499
0410 0498 0410 0498 0410 0498 0410 0498 0410 0498 0410 0498 0410 0498 0410 0498 0410 0498 0088 0088 0410 0498 0410 0498 0410 0498 0410 0498 0410 0498 0410 0498 0410 0498 0410 0498
0411 0499 0411 0499 0411 0499 0411 0499 0411 0499 0411 0499 0411 0499 0411 0499 0411 0499 0088 0088 0411 0499 0411 0499 0411 0499 0411 0499 0411 0499 0411 0499 0411 0499 0411 0499
END END

// t means collisions are true, f means collisions are false, digits are the code
// OB places are completely blocked by trees so you can't see black
