0088 0088 0088 0088 0088 0088 0088 0088 0088 0088 0088 0088 0088 0088 0088 0088 0088 0088 0088 0088 0088 0088 0088 0088 0088 0088 0088 0088 0088 0088
0088 0088 0088 0441 0441 0441 0088 0088 0088 0088 0088 0088 0088 0088 0088 0088 0088 0088 0441 0441 0441 0088 0088 0088 0088 0088 0088 0088 0088 0088
0088 0088 0088 0441 0088 0441 0088 0088 0088 0088 0088 0088 0088 0088 0088 0088 0088 0088 0441 0088 0441 0088 0088 0088 0088 0088 0088 0088 0088 0088
0088 0088 0088 0441 0441 0441 0088 0088 0088 0088 0352 0352 0088 0088 0088 0088 0088 0088 0441 0441 0441 0088 0088 0088 0088 0352 0352 0088 0088 0088
0088 0088 0088 0088 0088 0088 0088 0088 0088 0352 0352 0352 0088 0088 0088 0088 0088 0088 0088 0088 0088 0088 0088 0088 0352 0352 0352 0088 0088 0088
0129 0129 0129 0129 0129 0129 0129 0129 0129 0129 0129 0129 0088 0088 0088 0129 0129 0129 0129 0129 0129 0129 0129 0129 0129 0129 0129 0088 0088 0088 
0088 0088 0088 0088 0088 0088 0088 0088 0088 0088 0088 0088 0088 0088 0088 0088 0088 0088 0088 0088 0088 0088 0088 0088 0088 0088 0088 0088 0088 0088
0088 0088 0088 0088 0088 0088 0088 0088 0088 0088 0529 0088 0529 0088 0088 0088 0088 0088 0088 0088 0088 0088 0088 0088 0088 0529 0088 0529 0088 0088
0088 0088 0088 0088 0088 0088 0088 0088 0088 0088 3090 0088 3090 0088 0088 0088 0088 0088 0088 0088 0088 0088 0088 0088 0088 3090 0088 3090 0088 0088
0088 0088 0088 0088 0088 0088 0088 0088 0088 0088 0088 0088 0088 0088 0088 0088 0088 0088 0088 0088 0088 0088 0088 0088 0088 0088 0088 0088 0088 0088
0088 0088 0088 0088 0088 0088 0088 0088 0088 0088 0088 0088 0088 0088 0088 0088 0088 0088 0088 0088 0088 0088 0088 0088 0088 0088 0088 0088 0088 0088
0088 0088 0088 0441 0441 0441 0088 0088 0088 0088 0088 0088 0088 0088 0088 0088 0088 0088 0441 0441 0441 0088 0088 0088 0088 0088 0088 0088 0088 0088
0088 0088 0088 0441 0088 0441 0088 0088 0088 0088 0088 0088 0088 0088 0088 0088 0088 0088 0441 0088 0441 0088 0088 0088 0088 0088 0088 0088 0088 0088
0088 0088 0088 0441 0441 0441 0088 0088 0088 0088 0352 0352 0088 0088 0088 0088 0088 0088 0441 0441 0441 0088 0088 0088 0088 0352 0352 0088 0088 0088
0088 0088 0088 0088 0088 0088 0088 0088 0088 0352 0352 0352 0088 0088 0088 0088 0088 0088 0088 0088 0088 0088 0088 0088 0352 0352 0352 0088 0088 0088
0129 0129 0129 0129 0129 0129 0129 0129 0129 0129 0129 0129 0088 0088 0088 0129 0129 0129 0129 0129 0129 0129 0129 0129 0129 0129 0129 0088 0088 0088 
0088 0088 0088 0088 0088 0088 0088 0088 0088 0088 0088 0088 0088 0088 0088 0088 0088 0088 0088 0088 0088 0088 0088 0088 0088 0088 0088 0088 0088 0088
0088 0088 0088 0088 0088 0088 0088 0088 0088 0088 0529 0088 0529 0088 0088 0088 0088 0088 0088 0088 0088 0088 0088 0088 0088 0529 0088 0529 0088 0088
0088 0088 0088 0088 0088 0088 0088 0088 0088 0088 3090 0088 3090 0088 0088 0088 0088 0088 0088 0088 0088 0088 0088 0088 0088 3090 0088 3090 0088 0088
0088 0088 0088 0088 0088 0088 0088 0088 0088 0088 0088 0088 0088 0088 0088 0088 0088 0088 0088 0088 0088 0088 0088 0088 0088 0088 0088 0088 0088 0088
END END