0088 0088 0088 0088 0088 0088 0088 0088 0088 0088 0088 0088 0088 0088 0088
0088 0088 0441 0441 0088 0441 0441 0441 0088 0088 0441 0088 0088 0088 0088
0088 0441 0088 0088 0088 0441 0088 0441 0088 0441 0088 0088 0088 0088 0088
0088 0441 0088 0088 0088 0441 0088 0441 0088 0088 0441 0088 0088 0088 0088
0088 0088 0441 0088 0088 0441 0088 0441 0088 0088 0441 0088 0088 0088 0088
0088 0088 0088 0441 0088 0441 0088 0441 0088 0088 0441 0088 0088 0088 0088 
0088 0088 0088 0441 0088 0441 0088 0441 0088 0441 0088 0088 0088 0088 0088
0088 0441 0441 0088 0088 0441 0441 0441 0088 0088 0088 0088 0088 0088 0088
0088 0088 0088 0088 0088 0088 0088 0088 0088 0088 0088 0088 0088 0088 0088
0088 0088 0088 0088 0088 0088 0088 0088 0088 0088 0088 0088 0088 0088 0088